25 18 5 120
#########################
#      /                #
#           # #        !#
#                       #
# #########@##########  #
#                !   #  #
#  ################@##  #
#! #     !              #
#  #################### #
#                     # #
#                     # #
#                     # #
# ##@################## #
# #           !         #
# ##################@####
#                       #
#                       D
#########################