20 15 5 100
####################
#       #          #
#  /    @        ! #
#       #          #
#       #          #
#       #   ######@#
###@#######@#      #
#           #      D
#           @      #
#           #      #
#   !       #      #
#          ##      #
#          # !     #
#          @       #
####################